S.##......
#.##..###.
#.###.###.
#.S...###.
###.######

Axe 25 0.6
Sniper 26 0.4